pAppOnScreenStyle=Java_Event_pAppOnScreenStyle(PEnv,this);
pAppOnCreate=gApp.Init(PEnv,this,context,layout);AndroidModule1.Init(gApp);
pAppOnNewIntent=Java_Event_pAppOnNewIntent(PEnv,this);
pAppOnDestroy=Java_Event_pAppOnDestroy(PEnv,this);
pAppOnPause=Java_Event_pAppOnPause(PEnv,this);
pAppOnRestart=Java_Event_pAppOnRestart(PEnv,this);
pAppOnResume=Java_Event_pAppOnResume(PEnv,this);
pAppOnStart=Java_Event_pAppOnStart(PEnv,this);
pAppOnStop=Java_Event_pAppOnStop(PEnv,this);
pAppOnBackPressed=Java_Event_pAppOnBackPressed(PEnv,this);
pAppOnRotate=Java_Event_pAppOnRotate(PEnv,this,rotate);
pAppOnConfigurationChanged=Java_Event_pAppOnConfigurationChanged(PEnv,this);
pAppOnActivityResult=Java_Event_pAppOnActivityResult(PEnv,this,requestCode,resultCode,data);
pOnClick=Java_Event_pOnClick(PEnv,this,TObject(pasobj),value);
pOnClickCaptionItem=Java_Event_pOnClickCaptionItem(PEnv,this,TObject(pasobj),position,caption);
pOnClickWidgetItem=Java_Event_pOnClickWidgetItem(PEnv,this,TObject(pasobj),position,Boolean(checked));
pOnEnter=Java_Event_pOnEnter(PEnv,this,TObject(pasobj));
pOnTimer=Java_Event_pOnTimer(PEnv,this,TObject(pasobj));
pOnDraw=Java_Event_pOnDraw(PEnv,this,TObject(pasobj),canvas);
pOnTouch=Java_Event_pOnTouch(PEnv,this,TObject(pasobj),act,cnt,x1,y1,x2,y2);
pOnGLRenderer=Java_Event_pOnGLRenderer(PEnv,this,TObject(pasobj),EventType,w,h);
pOnClose=Java_Event_pOnClose(PEnv,this,TObject(pasobj));
pOnWebViewStatus=Java_Event_pOnWebViewStatus(PEnv,this,TObject(pasobj),EventType,url);
pAppOnCreateOptionsMenu=Java_Event_pAppOnCreateOptionsMenu(PEnv,this,menu);
pAppOnClickOptionMenuItem=Java_Event_pAppOnClickOptionMenuItem(PEnv,this,menuItem,itemID,itemCaption,Boolean(checked));
pAppOnPrepareOptionsMenu=Java_Event_pAppOnPrepareOptionsMenu(PEnv,this,menu,menuSize);
pAppOnPrepareOptionsMenuItem=Java_Event_pAppOnPrepareOptionsMenuItem(PEnv,this,menu,menuItem,itemIndex);
pAppOnCreateContextMenu=Java_Event_pAppOnCreateContextMenu(PEnv,this,menu);
pAppOnClickContextMenuItem=Java_Event_pAppOnClickContextMenuItem(PEnv,this,menuItem,itemID,itemCaption,Boolean(checked));
pOnBluetoothEnabled=Java_Event_pOnBluetoothEnabled(PEnv,this,TObject(pasobj));
pOnBluetoothDisabled=Java_Event_pOnBluetoothDisabled(PEnv,this,TObject(pasobj));
pOnBluetoothDeviceFound=Java_Event_pOnBluetoothDeviceFound(PEnv,this,TObject(pasobj),deviceName,deviceAddress);
pOnBluetoothDiscoveryStarted=Java_Event_pOnBluetoothDiscoveryStarted(PEnv,this,TObject(pasobj));
pOnBluetoothDiscoveryFinished=Java_Event_pOnBluetoothDiscoveryFinished(PEnv,this,TObject(pasobj),countFoundedDevices,countPairedDevices);
pOnBluetoothDeviceBondStateChanged=Java_Event_pOnBluetoothDeviceBondStateChanged(PEnv,this,TObject(pasobj),state,deviceName,deviceAddress);
pOnBluetoothClientSocketConnected=Java_Event_pOnBluetoothClientSocketConnected(PEnv,this,TObject(pasobj),deviceName,deviceAddress);
pOnBluetoothClientSocketIncomingData=Java_Event_pOnBluetoothClientSocketIncomingData(PEnv,this,TObject(pasobj),byteArrayContent,byteArrayHeader);
pOnBluetoothClientSocketDisconnected=Java_Event_pOnBluetoothClientSocketDisconnected(PEnv,this,TObject(pasobj));
pOnBluetoothServerSocketListen=Java_Event_pOnBluetoothServerSocketListen(PEnv,this,TObject(pasobj),serverName,strUUID);
pOnBluetoothServerSocketConnected=Java_Event_pOnBluetoothServerSocketConnected(PEnv,this,TObject(pasobj),deviceName,deviceAddress);
pOnBluetoothServerSocketIncomingData=Java_Event_pOnBluetoothServerSocketIncomingData(PEnv,this,TObject(pasobj),byteArrayContent,byteArrayHeader);
pOnBluetoothServerSocketAcceptTimeout=Java_Event_pOnBluetoothServerSocketAcceptTimeout(PEnv,this,TObject(pasobj));
pOnSpinnerItemSeleceted=Java_Event_pOnSpinnerItemSeleceted(PEnv,this,TObject(pasobj),position,caption);
pOnLocationChanged=Java_Event_pOnLocationChanged(PEnv,this,TObject(pasobj),latitude,longitude,altitude,address);
pOnLocationStatusChanged=Java_Event_pOnLocationStatusChanged(PEnv,this,TObject(pasobj),status,provider,msgStatus);
pOnLocationProviderEnabled=Java_Event_pOnLocationProviderEnabled(PEnv,this,TObject(pasobj),provider);
pOnLocationProviderDisabled=Java_Event_pOnLocationProviderDisabled(PEnv,this,TObject(pasobj),provider);
pAppOnViewClick=Java_Event_pAppOnViewClick(PEnv,this,view,id);
pAppOnListItemClick=Java_Event_pAppOnListItemClick(PEnv,this,adapter,view,position,id);
pOnActionBarTabSelected=Java_Event_pOnActionBarTabSelected(PEnv,this,TObject(pasobj),view,title);
pOnActionBarTabUnSelected=Java_Event_pOnActionBarTabUnSelected(PEnv,this,TObject(pasobj),view,title);
pOnCustomDialogShow=Java_Event_pOnCustomDialogShow(PEnv,this,TObject(pasobj),dialog,title);
pOnChange=Java_Event_pOnChange(PEnv,this,TObject(pasobj),txt,count);
pOnChanged=Java_Event_pOnChanged(PEnv,this,TObject(pasobj),txt,count);
pOnClickToggleButton=Java_Event_pOnClickToggleButton(PEnv,this,TObject(pasobj),Boolean(state));
pOnChangeSwitchButton=Java_Event_pOnChangeSwitchButton(PEnv,this,TObject(pasobj),Boolean(state));
pOnClickGridItem=Java_Event_pOnClickGridItem(PEnv,this,TObject(pasobj),position,caption);                            
pOnGridDrawItemCaptionColor=Java_Event_pOnGridDrawItemCaptionColor(PEnv,this,TObject(pasobj),position,caption);
pOnGridDrawItemBitmap=Java_Event_pOnGridDrawItemBitmap(PEnv,this,TObject(pasobj),position,caption);
pOnLongClickGridItem=Java_Event_pOnLongClickGridItem(PEnv,this,TObject(pasobj),position,caption);
pOnChangedSensor=Java_Event_pOnChangedSensor(PEnv,this,TObject(pasobj),sensor,sensorType,values,timestamp);
pOnListeningSensor=Java_Event_pOnListeningSensor(PEnv,this,TObject(pasobj),sensor,sensorType);
pOnUnregisterListeningSensor=Java_Event_pOnUnregisterListeningSensor(PEnv,this,TObject(pasobj),sensorType,sensorName);
pOnBroadcastReceiver=Java_Event_pOnBroadcastReceiver(PEnv,this,TObject(pasobj),intent);
pOnTimePicker=Java_Event_pOnTimePicker(PEnv,this,TObject(pasobj),hourOfDay,minute);
pOnDatePicker=Java_Event_pOnDatePicker(PEnv,this,TObject(pasobj),year,monthOfYear,dayOfMonth);
pOnFlingGestureDetected=Java_Event_pOnFlingGestureDetected(PEnv,this,TObject(pasobj),direction);
pOnPinchZoomGestureDetected=Java_Event_pOnPinchZoomGestureDetected(PEnv,this,TObject(pasobj),scaleFactor,state);
pOnShellCommandExecuted=Java_Event_pOnShellCommandExecuted(PEnv,this,TObject(pasobj),cmdResult);
pOnTCPSocketClientMessageReceived=Java_Event_pOnTCPSocketClientMessageReceived(PEnv,this,TObject(pasobj),messagesReceived);
pOnTCPSocketClientConnected=Java_Event_pOnTCPSocketClientConnected(PEnv,this,TObject(pasobj));
pOnAsyncEventDoInBackground=Java_Event_pOnAsyncEventDoInBackground(PEnv,this,TObject(pasobj),progress);
pOnAsyncEventProgressUpdate=Java_Event_pOnAsyncEventProgressUpdate(PEnv,this,TObject(pasobj),progress);
pOnAsyncEventPreExecute=Java_Event_pOnAsyncEventPreExecute(PEnv,this,TObject(pasobj));
pOnAsyncEventPostExecute=Java_Event_pOnAsyncEventPostExecute(PEnv,this,TObject(pasobj),progress);
pOnHttpClientContentResult=Java_Event_pOnHttpClientContentResult(PEnv,this,TObject(pasobj),content);
pOnHttpClientCodeResult=Java_Event_pOnHttpClientCodeResult(PEnv,this,TObject(pasobj),code);
pOnMediaPlayerPrepared=Java_Event_pOnMediaPlayerPrepared(PEnv,this,TObject(pasobj),videoWidth,videoHeigh);
pOnMediaPlayerVideoSizeChanged=Java_Event_pOnMediaPlayerVideoSizeChanged(PEnv,this,TObject(pasobj),videoWidth,videoHeight);
pOnMediaPlayerCompletion=Java_Event_pOnMediaPlayerCompletion(PEnv,this,TObject(pasobj));
pOnMediaPlayerTimedText=Java_Event_pOnMediaPlayerTimedText(PEnv,this,TObject(pasobj),timedText);
pOnSurfaceViewTouch=Java_Event_pOnSurfaceViewTouch(PEnv,this,TObject(pasobj),act,cnt,x1,y1,x2,y2);
pOnSurfaceViewCreated=Java_Event_pOnSurfaceViewCreated(PEnv,this,TObject(pasobj),surfaceHolder);
pOnSurfaceViewDraw=Java_Event_pOnSurfaceViewDraw(PEnv,this,TObject(pasobj),canvas);
pOnSurfaceViewChanged=Java_Event_pOnSurfaceViewChanged(PEnv,this,TObject(pasobj),width,height);                                             
pOnSurfaceViewDrawingInBackground=Java_Event_pOnSurfaceViewDrawingInBackground(PEnv,this,TObject(pasobj),progress);
pOnSurfaceViewDrawingPostExecute=Java_Event_pOnSurfaceViewDrawingPostExecute(PEnv,this,TObject(pasobj),progress);
pOnContactManagerContactsExecuted=Java_Event_pOnContactManagerContactsExecuted(PEnv,this,TObject(pasobj),count);
pOnContactManagerContactsProgress=Java_Event_pOnContactManagerContactsProgress(PEnv,this,TObject(pasobj),contactInfo,contactShortInfo,contactPhotoUriAsString,contactPhoto,progress);
pOnCustomDialogBackKeyPressed=Java_Event_pOnCustomDialogBackKeyPressed(PEnv,this,TObject(pasobj),title);
pOnListViewDrawItemCaptionColor=Java_Event_pOnListViewDrawItemCaptionColor(PEnv,this,TObject(pasobj),position,caption);
pOnListViewLongClickCaptionItem=Java_Event_pOnListViewLongClickCaptionItem(PEnv,this,TObject(pasobj),position,caption);
pOnListViewDrawItemBitmap=Java_Event_pOnListViewDrawItemBitmap(PEnv,this,TObject(pasobj),position,caption);
pOnSeekBarProgressChanged=Java_Event_pOnSeekBarProgressChanged(PEnv,this,TObject(pasobj),progress,Boolean(fromUser));
pOnSeekBarStartTrackingTouch=Java_Event_pOnSeekBarStartTrackingTouch(PEnv,this,TObject(pasobj),progress);
pOnSeekBarStopTrackingTouch=Java_Event_pOnSeekBarStopTrackingTouch(PEnv,this,TObject(pasobj),progress);
pOnRatingBarChanged=Java_Event_pOnRatingBarChanged(PEnv,this,TObject(pasobj),rating);
pRadioGroupCheckedChanged=Java_Event_pRadioGroupCheckedChanged(PEnv,this,TObject(pasobj),checkedIndex,checkedCaption);